Mapping from pinyin --> zhuyin.
sh --> ㄕ
ang --> ㄤ
eng --> ㄥ
a --> ㄚ
b --> ㄅ
c --> ㄘ
d --> ㄉ
ei --> ㄟ
ch --> ㄔ
e --> ㄜ
f --> ㄈ
ou --> ㄡ
g --> ㄍ
h --> ㄏ
ai --> ㄞ
en --> ㄣ
i --> ㄧ
j --> ㄐ
k --> ㄎ
l --> ㄌ
m --> ㄇ
an --> ㄢ
er --> ㄦ
n --> ㄋ
zh --> ㄓ
ao --> ㄠ
o --> ㄛ
p --> ㄆ
q --> ㄑ
r --> ㄖ
s --> ㄙ
t --> ㄊ
u --> ㄨ
x --> ㄒ
z --> ㄗ
ü --> ㄩ


{ iao yao } --> ㄧㄠ
{ ian yan } --> ㄧㄢ
{ ing ying } --> ㄧㄥ
{ üan yüan } --> ㄩㄢ
{ ong } --> ㄨㄥ
{ uang wang } --> ㄨㄤ
{ ui wei } --> ㄨㄟ
{ un wen } --> ㄨㄣ
{ ia ya } --> ㄧㄚ
{ ie ye } --> ㄧㄝ
{ weng } --> ㄨㄥ
{ iu you } --> ㄧㄡ
{ in yin } --> ㄧㄣ
{ uai wai } --> ㄨㄞ
{ uan wan } --> ㄨㄢ
{ iang yang } --> ㄧㄤ
{ ua wa } --> ㄨㄚ
{ uo wo } --> ㄨㄛ
{ üe yüe } --> ㄩㄝ
{ ün yün } --> ㄩㄣ




Mapping from zhuyin --> pinyin
ㄅ --> b
ㄆ --> p
ㄇ --> m
ㄈ --> f
ㄉ --> d
ㄊ --> t
ㄋ --> n
ㄌ --> l
ㄍ --> g
ㄎ --> k
ㄏ --> h
ㄐ --> j
ㄑ --> q
ㄒ --> x
ㄓ --> zh
ㄔ --> ch
ㄕ --> sh
ㄖ --> r
ㄗ --> z
ㄘ --> c
ㄙ --> s
ㄚ --> a
ㄛ --> o
ㄜ --> e
ㄞ --> ai
ㄟ --> ei
ㄠ --> ao
ㄡ --> ou
ㄢ --> an
ㄣ --> en
ㄤ --> ang
ㄥ --> eng
ㄦ --> er
ㄧ --> i
ㄨ --> u
ㄩ --> ü


ㄧㄝ --> { ie ye }
ㄨㄞ --> { uai wai }
ㄨㄟ --> { ui wei }
ㄩㄝ --> { üe yüe }
ㄨㄚ --> { ua wa }
ㄧㄚ --> { ia ya }
ㄨㄛ --> { uo wo }
ㄧㄥ --> { ing ying }
ㄨㄤ --> { uang wang }
ㄧㄣ --> { in yin }
ㄨㄥ --> { weng }
ㄧㄤ --> { iang yang }
ㄧㄡ --> { iu you }
ㄨㄢ --> { uan wan }
ㄩㄣ --> { ün yün }
ㄧㄢ --> { ian yan }
ㄨㄣ --> { un wen }
ㄧㄠ --> { iao yao }
ㄩㄢ --> { üan yüan }


